..........
..####....
.....#....
..K..#....
.....#....
..####....
..........